1111111111111111111111111111111111111111
10110000000010011001C1000100110000001011
1110011100001111001101000111100111001111
1000000000011100000000001110000000000111
1111110110000000001110111111111111011111
1011000000001001100000000100110000000011
1110111100001111001110000111100111000011
1001E00000011100P00000001110000000000111
1111100000000000000000000000000011111111
1011000000001001100000000100110000000011
1111111111111111111111111111111111111111
