1111111111111111111111111111111111111111
1011C0000000100110C1C1000100110P0C001011
1110011100001111001101000111100111001111
1C000000000111000000000C111C00000000C111
1111110110000000001110111111111111C11111
1011CC0000001001100000000100110000000C11
1110111100001111001110000111100111000C11
1001E00000011100C0000000111C00000000C111
1111100010000000000000000C00000011111111
1011C00000001CC11C0000000100110000000C11
1111111111111111111111111111111111111111
