
111111111
1EC0P0001
10C000001
111111111