
111111111
1C10P0001
10E000001
111111111