1111111111111
101100CCC0001
11100111CC001
100PEC00CC0E1
1111111111111