11111111111111111111111111111111111111111111111111
1PC111111111111111111111111111111111111111111111C1
1CCCCC000CCC000CCCC000CCC0000CCC000CCC0000CCC000C1
10111111111111111111111111111111111111111111111101
100CCC0000CCC000CCC0000CCC000CCCC000CCC000CCCC0001
10111111111111111111111111111111111111111111111101
1000CCC000CCCC000CCC0000CCC000CCC0000CCC000CCC0001
10111111111111111111111111111111111111111111111101
10000CCC000CCC0000CCC000CCCC000CCC000CCCC000CCC001
1C111111111111111111111111111111111111111111111101
1C000CCCC000CCC000CCCC000CCC0000CCC000CCC0000CCC01
1C111111111111111111111111111111111111111111111101
1CC000CCC0000CCC000CCCC000CCC000CCCC000CCC000CCCC1
1C1111111111111111111111111111111111111111111111C1
1CCC000CCC000CCCC000CCC0000CCC000CCC0000CCC000CCC1
1C1111111111111111111111111111111111111111111111C1
1CCC0000CCC000CCCC000CCC000CCCC000CCC000CCCC000CC1
1C1111111111111111111111111111111111111111111111C1
10CCC000CCCC000CCC0000CCC000CCC0000CCC000CCC0000C1
101111111111111111111111111111111111111111111111C1
100CCC000CCC0000CCC000CCCC000CCC000CCCC000CCC000C1
10111111111111111111111111111111111111111111111101
100CCCC000CCC0000CCC000CCC0000CCC000CCC0000CCC0001
10111111111111111111111111111111111111111111111101
1000CCC0000CCC000CCCC000CCC000CCCC000CCC000CCCC001
10111111111111111111111111111111111111111111111101
1C000CCC000CCCC000CCC0000CCC000CCC0000CCC000CCC001
1C111111111111111111111111111111111111111111111101
1C0000CCC000CCCC000CCC000CCCC000CCC000CCCC000CCC01
1C1111111111111111111111111111111111111111111111C1
1CC000CCCC000CCC0000CCC000CCC0000CCC000CCC0000CCC1
1C1111111111111111111111111111111111111111111111C1
1CC000CCC0000CCC000CCCC000CCC000CCCC000CCC000CCCC1
1C1111111111111111111111111111111111111111111111C1
1CCC000CCC0000CCC000CCC0000CCC000CCC0000CCC000CCC1
1C1111111111111111111111111111111111111111111111C1
1CCC0000CCC000CCCC000CCC000CCCC000CCC000CCCC000CC1
1C1111111111111111111111111111111111111111111111C1
10CCC0000CCC000CCC0000CCC000CCC0000CCC000CCC0000C1
101111111111111111111111111111111111111111111111C1
10CCC000CCCC000CCC000CCCC000CCC000CCCC000CCC000CC1
101111111111111111111111111111111111111111111111C1
10CCCC000CCC0000CCC000CCC0000CCC000CCC0000CCC000C1
10111111111111111111111111111111111111111111111101
100CCCC000CCC000CCCC000CCC000CCCC000CCC000CCCC0001
10111111111111111111111111111111111111111111111101
1000CCC0000CCC000CCC0000CCC000CCC0000CCC000CCC0001
10111111111111111111111111111111111111111111111101
100CCC000CCCC000CCC000CCCC000CCC000CCCC000CCC000E1
11111111111111111111111111111111111111111111111111
