1111111111
1PC1111101
1C00CCC001
1C11111101
1C0000CCC1
1C111111C1
1CCC000CC1
10111111C1
10CCCC00E1
1111111111
