1111111111111111111111111111111111111111111111111111111111111111111111111111111111111111111111111111
1PC11111111111111111111111111111111111111111111111111111111111111111111111111111111111111111111111C1
1CCCC000CCC0000CCC000CCC0000CCC000CCC0000CCC000CCC0000CCC000CCC0000CCC000CCCC000CCC000CCCC000CCC0001
1011111111111111111111111111111111111111111111111111111111111111111111111111111111111111111111111101
1000CCCC000CCC000CCCC000CCC0000CCC000CCC0000CCC000CCC0000CCC000CCC0000CCC000CCCC000CCC000CCCC000CCC1
1C111111111111111111111111111111111111111111111111111111111111111111111111111111111111111111111111C1
1CCC00CCCC000CCC000CCCC000CCC0000CCC000CCC0000CCC000CCC0000CCC000CCC0000CCC000CCCC000CCC000CCCC000C1
10111111111111111111111111111111111111111111111111111111111111111111111111111111111111111111111111C1
100CCC000CCCC000CCC000CCCC000CCC0000CCC000CCC0000CCC000CCC0000CCC000CCC0000CCC000CCC0000CCC000CCCC01
1C11111111111111111111111111111111111111111111111111111111111111111111111111111111111111111111111101
1CC000CCC000CCCC000CCC000CCCC000CCC0000CCC000CCC0000CCC000CCC0000CCC000CCC0000CCC000CCC0000CCC000CC1
10111111111111111111111111111111111111111111111111111111111111111111111111111111111111111111111111C1
10CCCC000CCC000CCCC000CCC000CCCC000CCC000CCCC000CCC0000CCC000CCC0000CCC000CCC0000CCC000CCC0000CCC001
1C11111111111111111111111111111111111111111111111111111111111111111111111111111111111111111111111101
1C000CCCC000CCC000CCCC000CCC000CCCC000CCC000CCCC000CCC0000CCC000CCC0000CCC000CCC0000CCC000CCC0000CC1
1C111111111111111111111111111111111111111111111111111111111111111111111111111111111111111111111111C1
10CCC000CCCC000CCC000CCCC000CCC000CCCC000CCC000CCCC000CCC0000CCC000CCC0000CCC000CCC0000CCC000CCC0001
1011111111111111111111111111111111111111111111111111111111111111111111111111111111111111111111111101
10000CCC000CCCC000CCC000CCCC000CCC000CCCC000CCC000CCCC000CCC000CCCC000CCC0000CCC000CCC000CCC00CCC001
1C11111111111111111111111111111111111111111111111111111111111111111111111111111111111111111111111101
1C0000CCC000CCCC000CCC000CCCC000CCC000CCCC000CCC000CCCC000CCC000CCCC000CCC0000CCC000CCC0000CCC000CC1
10111111111111111111111111111111111111111111111111111111111111111111111111111111111111111111111111C1
1CCC0000CCC000CCCC000CCC000CCCC000CCC000CCCC000CCC000CCCC000CCC000CCCC000CCC0000CCC000CCC0000CCC0001
1011111111111111111111111111111111111111111111111111111111111111111111111111111111111111111111111101
1000CCC000CCC000CCC0000CCC000CCCC000CCC000CCCC000CCC000CCCC000CCC000CCCC000CCC0000CCC000CCC0000CCC01
1C11111111111111111111111111111111111111111111111111111111111111111111111111111111111111111111111101
1CC000CCC0000CCC000CCC0000CCC000CCCC000CCC000CCCC000CCC000CCCC000CCC000CCCC000CCC000CCCC000CCC0000C1
10111111111111111111111111111111111111111111111111111111111111111111111111111111111111111111111111C1
100CCC000CCC0000CCC000CCC0000CCC000CCCC000CCC000CCCC000CCC000CCCC000CCC000CCCC000CCC000CCCC000CCC001
1C11111111111111111111111111111111111111111111111111111111111111111111111111111111111111111111111101
1C0000CCC000CCC0000CCC000CCC0000CCC000CCC0000CCC000CCCC000CCC000CCCC000CCC000CCCC000CCC000CCCC000CC1
10111111111111111111111111111111111111111111111111111111111111111111111111111111111111111111111111C1
10CCC0000CCC000CCC0000CCC000CCC0000CCC000CCC0000CCC000CCCC000CCC000CCCC000CCC000CCCC000CCC000CCCC001
1011111111111111111111111111111111111111111111111111111111111111111111111111111111111111111111111101
1C000CCC0000CCC000CCC0000CCC000CCC0000CCC000CCC0000CCC000CCCC000CCC000CCCC000CCC000CCCC000CCC000CCC1
1C111111111111111111111111111111111111111111111111111111111111111111111111111111111111111111111111C1
1CCCC000CCC0000CCC000CCC0000CCC000CCC0000CCC000CCC0000CCC000CCCC000CCC000CCCC000CCC000CCCC000CCC0001
1011111111111111111111111111111111111111111111111111111111111111111111111111111111111111111111111101
1000CCCC000CCC0000CCC000CCC0000CCC000CCC0000CCC000CCC0000CCC000CCC0000CCC000CCCC000CCC000CCCC000CCC1
1C111111111111111111111111111111111111111111111111111111111111111111111111111111111111111111111111C1
1CCC000CCCC000CCC0000CCC000CCC0000CCC000CCC0000CCC000CCC0000CCC000CCC0000CCC000CCCC000CCC000CCCC0001
1011111111111111111111111111111111111111111111111111111111111111111111111111111111111111111111111101
1000CCC000CCCC000CCC00CCCC000CCC0000CCC000CCC0000CCC000CCC0000CCC000CCC0000CCC000CCCC000CCC000CCCC01
1C11111111111111111111111111111111111111111111111111111111111111111111111111111111111111111111111101
1CC000CCC000CCCC000CCC000CCCC000CCC0000CCC000CCC0000CCC000CCC0000CCC000CCC0000CCC000CCC0000CCC000CC1
10111111111111111111111111111111111111111111111111111111111111111111111111111111111111111111111111C1
10CCCC000CCC000CCCC000CCC000CCCC000CCC0000CCC000CCC0000CCC000CCC0000CCC000CCC0000CCC000CCC0000CCC001
1C11111111111111111111111111111111111111111111111111111111111111111111111111111111111111111111111101
1C000CCCC000CCC000CCCC000CCC000CCCC000CCC0000CCC000CCC0000CCC000CCC0000CCC000CCC0000CCC000CCC0000CC1
1C111111111111111111111111111111111111111111111111111111111111111111111111111111111111111111111111C1
10CCC000CCCC000CCC000CCCC000CCC000CCCC000CCC000CCCC000CCC0000CCC000CCC0000CCC000CCC0000CCC000CCC0001
1011111111111111111111111111111111111111111111111111111111111111111111111111111111111111111111111101
1C000CCC000CCCC000CCC000CCCC000CCC000CCCC000CCC000CCCC000CCC0000CCC000CCC0000CCC000CCC0000CCC000CCC1
1C111111111111111111111111111111111111111111111111111111111111111111111111111111111111111111111111C1
1CCC0000CCC000CCCC000CCC000CCCC000CCC000CCCC000CCC000CCCC000CCC0000CCC000CCC0000CCC000CCC0000CCC0001
1011111111111111111111111111111111111111111111111111111111111111111111111111111111111111111111111101
1000CCC0000CCC000CCCC000CCC000CCCC000CCC000CCCC000CCC000CCCC000CCC000CCCC000CCC0000CCC000CCC0000CCC1
1C111111111111111111111111111111111111111111111111111111111111111111111111111111111111111111111111C1
1CCC000CCC0000CCC000CCCC000CCC000CCCC000CCC000CCCC000CCC000CCCC000CCC000CCCC000CCC0000CCC000CCC00001
1011111111111111111111111111111111111111111111111111111111111111111111111111111111111111111111111101
1000CCC000CCC0000CCC000CCC0000CCC000CCCC000CCC000CCCC000CCC000CCCC000CCC000CCCC000CCC000CCC000CCC001
1C11111111111111111111111111111111111111111111111111111111111111111111111111111111111111111111111101
1C0000CCC000CCC0000CCC000CCC0000CCC000CCCC000CCC000CCCC000CCC000CCCC000CCC000CCCC000CCC0000CCC000CC1
10111111111111111111111111111111111111111111111111111111111111111111111111111111111111111111111111C1
10CCC0000CCC000CCC0000CCC000CCC0000CCC000CCCC000CCC000CCCC000CCC000CCCC000CCC000CCCC000CCC000CCCC001
1011111111111111111111111111111111111111111111111111111111111111111111111111111111111111111111111101
1C000CCC0000CCC000CCC0000CCC000CCC0000CCC000CCCC000CCC000CCCC000CCC000CCCC000CCC000CCCC000CCC000CCC1
1C111111111111111111111111111111111111111111111111111111111111111111111111111111111111111111111111C1
10CCC000CCC0000CCC000CCC0000CCC000CCC0000CCC000CCC0000CCC000CCCC000CCC000CCCC000CCC000CCCC000CCC0001
1011111111111111111111111111111111111111111111111111111111111111111111111111111111111111111111111101
10000CCC000CCC0000CCC000CCC0000CCC000CCC0000CCC000CCC0000CCC000CCCC000CCC000CCCC000CCC000CCCC000CCC1
1C111111111111111111111111111111111111111111111111111111111111111111111111111111111111111111111111C1
1CCC000CCCC000CCC0000CCC000CCC0000CCC000CCC0000CCC000CCC0000CCC000CCCC000CCC000CCCC000CCC000CCCC0001
1011111111111111111111111111111111111111111111111111111111111111111111111111111111111111111111111101
1000CCC000CCCC000CCC0000CCC000CCC0000CCC000CCC0000CCC000CCC0000CCC000CCC0000CCC000CCCC000CCC000CCCC1
1C111111111111111111111111111111111111111111111111111111111111111111111111111111111111111111111111C1
1CCC000CCC000CCCC000CC0000CC000CCC0000CCC000CCC0000CCC000CCC0000CCC000CCC0000CCC000CCCC000CCC000CCC1
1C111111111111111111111111111111111111111111111111111111111111111111111111111111111111111111111111C1
1CCCC000CCC000CCCC000CCC0000CCC000CCC0000CCC000CCC0000CCC000CCC0000CCC000CCC0000CCC000CCCC000CCC0001
1011111111111111111111111111111111111111111111111111111111111111111111111111111111111111111111111101
1000CCCC00CCC000CCCC000CCC000CCCC000CCC0000CCC000CCC0000CCC000CCC0000CCC000CCC0000CCC000CCCC000CCC01
1C111111111111111111111111111111111111111111111111111111111111111111111111111111111111111111111111C1
1CC000CCCC000CCC000CCCC000CCC000CCCC000CCC0000CCC000CCC0000CCC000CCC0000CCC000CCC0000CCC000CCC0000C1
10111111111111111111111111111111111111111111111111111111111111111111111111111111111111111111111111C1
100CCC000CCCC000CCC000CCCC000CCC000CCCC000CCC0000CCC000CCC0000CCC000CCC0000CCC000CCC0000CCC000CCC001
1C11111111111111111111111111111111111111111111111111111111111111111111111111111111111111111111111101
1CC000CCC000CCCC000CCC000CCCC000CCC000CCCC000CCC000CCCC000CCC0000CCC000CCC0000CCC000CCC0000CCC000CC1
10111111111111111111111111111111111111111111111111111111111111111111111111111111111111111111111111C1
10CCCC000CCC000CCCC000CCC000CCCC000CCC000CCCC000CCC000CCCC000CCC0000CCC000CCC0000CCC000CCC0000CCC001
1011111111111111111111111111111111111111111111111111111111111111111111111111111111111111111111111101
1C000CCCC000CCC000CCCC000CCC000CCCC000CCC000CCCC000CCC000CCCC000CCC0000CCC000CCC0000CCC000CCC0000CC1
1C111111111111111111111111111111111111111111111111111111111111111111111111111111111111111111111111C1
10CCC000CCC0000CCC000CCCC000CCC000CCCC000CCC000CCCC000CCC000CCCC000CCC0000CCC000CCC0000CCC000CCC0001
1011111111111111111111111111111111111111111111111111111111111111111111111111111111111111111111111101
10000CCC000CCC0000CCC000CCCC000CCC000CCCC000CCC000CCCC000CCC000CCCC000CCC000CCCC000CCC0000CCC000CCC1
1C111111111111111111111111111111111111111111111111111111111111111111111111111111111111111111111111C1
1CCC0000CCC000CCC0000CCC000CCCC000CCC000CCCC000CCC000CCCC000CCC000CCCC000CCC000CCCC000CCC0000CCC0001
1011111111111111111111111111111111111111111111111111111111111111111111111111111111111111111111111101
1000CCC0000CCC000CCC0000CCC000CCC0000CC000CCCC000CCC000CCCC000CCC000CCCC000CCC000CCCC000CCC0000CCCE1
1111111111111111111111111111111111111111111111111111111111111111111111111111111111111111111111111111
